08 08 08 08 08 08 08 08 08 08 08 08 08 08 08 08 08 08 08 08 08
08 10 00 00 01 01 01 01 01 01 01 01 01 01 01 01 00 00 10 01 08
08 00 00 01 01 01 08 01 01 01 01 01 00 01 01 01 01 00 00 01 08
08 00 01 01 01 08 00 01 01 01 01 01 01 00 01 01 01 01 00 01 08
08 01 01 08 08 08 01 01 01 01 00 01 00 01 01 01 01 01 01 01 08
08 01 01 08 08 08 00 01 01 08 08 08 01 01 01 00 01 00 01 01 08
08 01 00 08 08 08 00 01 01 00 08 08 01 01 01 01 00 01 01 01 08
08 01 01 01 08 00 00 01 01 08 08 08 01 01 01 01 01 01 01 01 08
08 01 01 01 08 08 01 01 01 00 00 00 01 01 01 01 01 01 01 01 08
08 01 01 01 01 00 08 01 00 00 00 00 00 01 01 01 01 01 01 01 08
08 01 01 01 01 00 00 00 00 00 00 00 00 00 01 01 01 01 01 01 08
08 01 01 01 01 01 01 01 00 00 00 00 00 01 01 01 01 01 01 01 08
08 01 01 01 01 01 01 01 01 00 00 00 01 01 01 01 01 01 01 01 08
08 01 01 01 01 01 01 01 01 01 00 01 01 01 01 01 01 01 01 01 08
08 01 00 01 01 01 00 08 01 01 01 00 01 01 01 01 01 01 01 01 08
08 01 00 01 01 01 01 00 01 01 01 01 01 01 01 00 01 01 01 01 08
08 01 01 01 01 01 01 01 00 01 01 01 00 01 01 01 01 01 01 01 08
08 00 01 01 01 00 01 01 01 01 00 01 01 01 01 00 01 01 00 01 08
08 00 00 01 01 01 01 01 00 01 01 00 01 01 01 01 01 00 00 01 08
08 10 00 00 01 00 01 01 01 00 01 01 01 00 01 01 00 00 10 01 08
08 08 08 08 08 08 08 08 08 08 08 08 08 08 08 08 08 08 08 08 08
